1111111111111111111
1222222221222222221
1222222222222222221
1222222221112222221
1222222222222222221
1222222222222222221
1222222222222222221
1222222222222222221
1222222222222222221
1111111111111111111